#########
#   A   #
# ##### #
#       #
# #######
#       #
#A#A#A###
#       #
#########